
  $ #
    ######
  ###    #      #
         #      #
         #      #
         ##############
         #            #
         #            #
      ###########     #
