
  $##        #
    #####################
  ###    #      #     #
         #      #######
         #      #     #
         ##############
         #            #
         #            #
      ###########     #
  ###
  #
  #     #
  ######$########
  #     #
  ####  ###
  #     #
